---------------------------------------------------------------------------------------------------
-                                 ####################                                            -
-                             =====                  #                                            -
-                             =   #                  #                            #######         -
-      ###############        =   #                  #                            #     #         -
-      #             #        =   #                  ==============================     #         -
-      #             #        =   #                  #                            #     #         -
-      #             #        =   #                  #                            ###=###         -
-      #             ==========   ##########=#########                               =            -
-      #             #                      =                                        =            -
-      #             #                      =                                        =            -
-      #             #                      =                                        =            -
-      ######=########               #######=#######                                 =            -
-            =                       #             #                                 =            -
-            =                       #             #                                 =            -
-            =                       #             #         ##############          =            -
- #####   ###=####                   #             #         #            #          =            -
- #   #   #      #                   #             #         #            #          =            -
- #   =====      #                   #             #         #            # #########=#######     -
- #   #   #      #                   #             #         #            # #               #     -
- #####   ####=###                   #             #         #            ===               #     -
-             =                      #             #         #            # #               #     -
-             =                      ###############         ############## #               #     -
-             =                                                             #               #     -
-             ===============================================================               #     -
-                                                                           #################     -
---------------------------------------------------------------------------------------------------