---------------------------------------------------------------------------------------------------
-                                                                                                 -
-                                                                                                 -
-        ###############                    ############################                          -
-        #             #                    #                          #                          -
-        #             #                    #                          #                          -
-        #             ======================                          ==================         -
-        #             #                    #                          #                =         -
-        #             #                    #                          #                =         -
-        #=#############                    ############################                =         -
-         =                                                                             =         -
-         =          ###########     ##########################                         =         -
-         =          #         #     #                        #                         =         -
-         =          #         #     #                        #                         =         -
-         =          #         =======                        #                         =         -
-         =          #         #     #                        #                         =         -
-  #######=######    #         #     #                        #                         =         -
-  #            #    #         #     ###=#########=############           ##############=######   -
-  #            #    #         #        =         =                       #                   #   -
-  #            #    ###########        =         =                       #                   #   -
-  #            #                       =         =========================                   #   -
-  #            =======                 =                                 #                   #   -
-  #            #     =                 =                                 #                   #   -
-  #            #     =                 =                                 #                   #   -
-  #            #     =                 =                                 #####################   -
-  ##############     ===================                                                         -
---------------------------------------------------------------------------------------------------