---------------------------------------------------------------------------------------------------
-                                                                                                 -
-                                  ##################      ==============================         -
-     #############                #                #      =                            =         -
-     #           #                #                #      =                            =         -
-     #           #                #                ========                            =         -
-     #           ========         #                #                           ########=######   -
-     #           #      =         #                #                           #             #   -
-     #############      =         #                #                           #             #   -
-                        =         ##################                 ===========             #   -
-     ##############     =                                            =         #             #   -
-     #            #     =                                            =         #             #   -
-     #            #     =                                            =         #             #   -
-     #            =======          ==================                =         #             #   -
-     #            #                =                =                =         ###############   -
-     #            #                =                =                =                           -
-     #            #                =                =                =                           -
-     #####=########                =                =       #########=##########                 -
-          =                 #######=########        =       #                  #                 -
-          =                 #              #        =       #                  #                 -
-          =                 #              #        =       #                  #                 -
-          =                 #              #        =========                  #                 -
-          =           =======              #                #                  #                 -
-          =           =     #              #                #                  #                 -
-          =============     ################                ####################                 -
-                                                                                                 -
---------------------------------------------------------------------------------------------------