---------------------------------------------------------------------------------------------------
-                                                                                                 -
-      ####################             #################             ###################         -
-      #                  #             #               #             #                 #         -
-      #                  #             #               #             #                 #         -
-      #                  #             #               #             #                 #         -
-      #                  ===============               ===============                 #         -
-      #                  #             #               #             #                 #         -
-      #                  #             #               #             #                 #         -
-      ####################             ########=########             ##########=########         -
-                                               =                               =                 -
-   ##########                                  =                               =                 -
-   #        #                                  =                               =                 -
-   #        #                                  =                               =   ###########   -
-   #        #                                  =                               =   #         #   -
-   #        =============                      =                               =   #         #   -
-   #        #           =                      =                               =====         #   -
-   #        #           =               #######=############                       #         #   -
-   #        #           =               #                  #                       #         #   -
-   #        #           =================                  #                       #####=#####   -
-   #        #                           #                  #                            =        -
-   #        #                           #                  ========                     =        -
-   ##########                           #                  #      =                     =        -
-                                        #                  #      =                     =        -
-                                        ####################      =======================        -
-                                                                                                 -
---------------------------------------------------------------------------------------------------