---------------------------------------------------------------------------------------------------
-                                 ####################                                            -
-                                 #                  #                       ##############       -
-                                 #                  #                       #            #       -
-                                 #                  #                       #            #       -
-                                 #                  #            ============            #       -
-   #############                 #########=##########            =          #            #       -
-   #           #                          =                      =          #            #       -
-   #           #                          =                      =          #            #       -
-   #           ======                     =                      =          #            #       -
-   #           #    =                     =                      =          ##############       -
-   #           #    =             ########=##########            =                               -
-   #           #    =             #                 #            =                               -
-   #           #    =             #                 ==============   #######################     -
-   #############    ===============                 #                #                     #     -
-                                  #                 #                #                     #     -
-                                  #                 ==================                     #     -
-                                  #                 #                #                     #     -
-  ##############                  #                 #                #                     #     -
-  #            #                  #                 =========        #######################     -
-  #            #    ===============                 #       =                                    -
-  #            #    =             #                 #       =       ################             -
-  #            ======             ###################       =       #              #             -
-  #            #                                            =========              #             -
-  #            #                                                    #              #             -
-  ##############                                                    ################             -
---------------------------------------------------------------------------------------------------