---------------------------------------------------------------------------------------------------
-                                                                                                 -
-   #################                                            #######################          -
-   #               #                         ====================                     #          -
-   #               #                         =                  #                     #          -
-   #               =================         =                  #                     #          -
-   #               #               =         =                  #                     #          -
-   #               #               =         =                  #                     #          -
-   #               #               =         =                  ###########=###########          -
-   #               #             ##=#########=###########                  =                     -
-   #################             #                      #                  =                     -
-                                 #                      #                  =                     -
-                                 #                      #                  =                     -
-                 =================                      ====================                     -
-                 =               #                      #                                        -
-                 =               #                      #                   #################    -
-                 =               #                      ===========         #               #    -
-       ##########=########       ###########=############         =         #               #    -
-       #                 #                  =                     =         #               #    -
-       #                 #                  =                     =         #               #    -
-       #                 #                  =                     =         #               #    -
-       #                 #                  =                     ===========               #    -
-       #                 #                  =                               #               #    -
-       #                 ====================                               #               #    -
-       ###################                                                  #################    -
-                                                                                                 -
---------------------------------------------------------------------------------------------------